Year,City,Population,In-migration,Out-migration,Net-migration
2020,ADANA,2258718,47088,45832,1256
2020,ADIYAMAN,632459,16163,16936,-773
2020,AFYONKARAHISAR,736912,18439,19434,-995
2020,AGRI,535435,14626,24353,-9727
2020,AMASYA,335494,12241,11347,894
2020,ANKARA,5663322,153162,141165,11997
2020,ANTALYA,2548308,83035,62325,20710
2020,ARTVIN,169501,6358,7801,-1443
2020,AYDIN,1119084,35455,30996,4459
2020,BALIKESIR,1240285,40715,31561,9154
2020,BILECIK,218717,8297,8439,-142
2020,BINGOL,281768,9497,10633,-1136
2020,BITLIS,350994,12050,14223,-2173
2020,BOLU,314802,11430,12565,-1135
2020,BURDUR,267092,9201,11422,-2221
2020,BURSA,3101833,77039,53940,23099
2020,CANAKKALE,541548,21055,19022,2033
2020,CANKIRI,192428,9955,12614,-2659
2020,CORUM,530126,15672,15051,621
2020,DENIZLI,1040915,22534,21370,1164
2020,DIYARBAKIR,1783431,39101,42992,-3891
2020,EDIRNE,407763,12252,14264,-2012
2020,ELAZIG,587960,15529,21166,-5637
2020,ERZINCAN,234431,10907,10998,-91
2020,ERZURUM,758279,20405,30220,-9815
2020,ESKISEHIR,888828,25376,25533,-157
2020,GAZIANTEP,2101157,42040,41179,861
2020,GIRESUN,448721,17654,17368,286
2020,GUMUSHANE,141702,7151,19116,-11965
2020,HAKKARI,280514,7227,8421,-1194
2020,HATAY,1659320,35160,29265,5895
2020,ISPARTA,440304,12879,17905,-5026
2020,MERSIN,1868757,53325,40242,13083
2020,ISTANBUL,15462452,328632,381654,-53022
2020,IZMIR,4394694,107172,92400,14772
2020,KARS,284923,8168,12910,-4742
2020,KASTAMONU,376377,14177,15328,-1151
2020,KAYSERI,1421455,31766,30033,1733
2020,KIRKLARELI,361737,13852,11596,2256
2020,KIRSEHIR,243042,9960,10835,-875
2020,KOCAELI,1997258,75093,52543,22550
2020,KONYA,2250020,43788,48780,-4992
2020,KUTAHYA,576688,15347,18688,-3341
2020,MALATYA,806156,24198,23329,869
2020,MANISA,1450616,37003,29833,7170
2020,KAHRAMANMARAS,1168163,25056,23696,1360
2020,MARDIN,854716,25373,24744,629
2020,MUGLA,1000773,41468,28088,13380
2020,MUS,411117,11720,16548,-4828
2020,NEVSEHIR,304962,9309,8958,351
2020,NIGDE,362071,11349,13588,-2239
2020,ORDU,761400,26898,21406,5492
2020,RIZE,344359,13143,13290,-147
2020,SAKARYA,1042649,30929,24888,6041
2020,SAMSUN,1356079,43054,35442,7612
2020,SIIRT,331070,9044,12958,-3914
2020,SINOP,216460,10292,11070,-778
2020,SIVAS,635889,18490,23885,-5395
2020,TEKIRDAG,1081065,50764,28468,22296
2020,TOKAT,597861,24840,41746,-16906
2020,TRABZON,811901,23761,24506,-745
2020,TUNCELI,83443,5791,6311,-520
2020,SANLIURFA,2115256,37720,47194,-9474
2020,USAK,369433,8756,10428,-1672
2020,VAN,1149342,26621,38114,-11493
2020,YOZGAT,419095,14109,17604,-3495
2020,ZONGULDAK,591204,15243,19593,-4350
2020,AKSARAY,423011,12208,12311,-103
2020,BAYBURT,81910,4427,7433,-3006
2020,KARAMAN,254919,8074,8304,-230
2020,KIRIKKALE,278703,8597,13021,-4424
2020,BATMAN,620278,18598,17593,1005
2020,SIRNAK,537762,14461,15008,-547
2020,BARTIN,198979,7585,7441,144
2020,ARDAHAN,96161,4085,5215,-1130
2020,IGDIR,201314,7452,7266,186
2020,YALOVA,276050,14661,10281,4380
2020,KARABUK,243614,8148,12750,-4602
2020,KILIS,142792,5035,6432,-1397
2020,OSMANIYE,548556,17734,14954,2780
2020,DUZCE,395679,11757,10565,1192
2019,ADANA,2237940,52290,60900,-8610
2019,ADIYAMAN,626465,17619,24821,-7202
2019,AFYONKARAHISAR,729483,23818,27006,-3188
2019,AGRI,536199,16342,28158,-11816
2019,AMASYA,337800,13329,14813,-1484
2019,ANKARA,5639076,211744,154464,57280
2019,ANTALYA,2511700,100140,68494,31646
2019,ARTVIN,170875,8403,11676,-3273
2019,AYDIN,1110972,40439,36180,4259
2019,BALIKESIR,1228620,41467,42931,-1464
2019,BILECIK,219427,10565,10582,-17
2019,BINGOL,279812,11266,14879,-3613
2019,BITLIS,348115,12385,19050,-6665
2019,BOLU,316126,15997,15068,929
2019,BURDUR,270796,12134,13603,-1469
2019,BURSA,3056120,85596,68356,17240
2019,CANAKKALE,542157,25198,22293,2905
2019,CANKIRI,195789,11381,32275,-20894
2019,CORUM,530864,16006,23425,-7419
2019,DENIZLI,1037208,26235,27146,-911
2019,DIYARBAKIR,1756353,42329,49730,-7401
2019,EDIRNE,413903,16864,16761,103
2019,ELAZIG,591098,20343,29248,-8905
2019,ERZINCAN,234747,14496,17555,-3059
2019,ERZURUM,762062,26819,40401,-13582
2019,ESKISEHIR,887475,36757,29543,7214
2019,GAZIANTEP,2069364,52268,53517,-1249
2019,GIRESUN,448400,22595,30580,-7985
2019,GUMUSHANE,164521,16158,25477,-9319
2019,HAKKARI,280991,6898,12719,-5821
2019,HATAY,1628894,35244,42067,-6823
2019,ISPARTA,444914,19555,20052,-497
2019,MERSIN,1840425,55429,54452,977
2019,ISTANBUL,15519267,498676,378305,120371
2019,IZMIR,4367251,128370,106895,21475
2019,KARS,285410,11132,16421,-5289
2019,KASTAMONU,379405,17737,22515,-4778
2019,KAYSERI,1407409,40579,39013,1566
2019,KIRKLARELI,361836,15352,14468,884
2019,KIRSEHIR,242938,10853,13028,-2175
2019,KOCAELI,1953035,82977,65675,17302
2019,KONYA,2232374,54219,58557,-4338
2019,KUTAHYA,579257,21212,21456,-244
2019,MALATYA,800165,29880,33272,-3392
2019,MANISA,1440611,40857,37164,3693
2019,KAHRAMANMARAS,1154102,27676,36700,-9024
2019,MARDIN,838778,27395,32544,-5149
2019,MUGLA,983142,42987,36210,6777
2019,MUS,408809,13396,20063,-6667
2019,NEVSEHIR,303010,12571,11899,672
2019,NIGDE,362861,14055,20769,-6714
2019,ORDU,754198,25386,46640,-21254
2019,RIZE,343212,15946,23534,-7588
2019,SAKARYA,1029650,35941,31291,4650
2019,SAMSUN,1348542,45973,45020,953
2019,SIIRT,330280,11016,17252,-6236
2019,SINOP,218243,12926,15642,-2716
2019,SIVAS,638956,23572,36430,-12858
2019,TEKIRDAG,1055412,48911,38109,10802
2019,TOKAT,612747,39530,39567,-37
2019,TRABZON,808974,29603,37502,-7899
2019,TUNCELI,84660,6517,8179,-1662
2019,SANLIURFA,2073614,41841,60885,-19044
2019,USAK,370509,13117,12363,754
2019,VAN,1136757,34372,39575,-5203
2019,YOZGAT,421200,18009,25253,-7244
2019,ZONGULDAK,596053,19654,26251,-6597
2019,AKSARAY,416367,13689,15672,-1983
2019,BAYBURT,84843,9131,7882,1249
2019,KARAMAN,253279,10318,11075,-757
2019,KIRIKKALE,283017,12937,18854,-5917
2019,BATMAN,608659,20902,23325,-2423
2019,SIRNAK,529615,16365,20724,-4359
2019,BARTIN,198249,9423,10708,-1285
2019,ARDAHAN,97319,5164,7028,-1864
2019,IGDIR,199442,8650,9777,-1127
2019,YALOVA,270976,14531,12824,1707
2019,KARABUK,248458,14571,16485,-1914
2019,KILIS,142490,6515,8843,-2328
2019,OSMANIYE,538759,18126,21459,-3333
2019,DUZCE,392166,15454,14798,656
2018,ADANA,2220125,51660,70638,-18978
2018,ADIYAMAN,624513,22034,22897,-863
2018,AFYONKARAHISAR,725568,26976,25049,1927
2018,AGRI,539657,20091,29482,-9391
2018,AMASYA,337508,16760,15237,1523
2018,ANKARA,5503985,184382,221747,-37365
2018,ANTALYA,2426356,95920,80349,15571
2018,ARTVIN,174010,15934,8876,7058
2018,AYDIN,1097746,47005,36462,10543
2018,BALIKESIR,1226575,55238,40028,15210
2018,BILECIK,223448,11956,12597,-641
2018,BINGOL,281205,15770,12216,3554
2018,BITLIS,349396,17602,17398,204
2018,BOLU,311810,18307,14827,3480
2018,BURDUR,269926,15417,12537,2880
2018,BURSA,2994521,80940,80086,854
2018,CANAKKALE,540662,29473,21068,8405
2018,CANKIRI,216362,40460,12433,28027
2018,CORUM,536483,24363,20212,4151
2018,DENIZLI,1027782,28047,28906,-859
2018,DIYARBAKIR,1732396,43836,50822,-6986
2018,EDIRNE,411528,18792,17162,1630
2018,ELAZIG,595638,30152,24358,5794
2018,ERZINCAN,236034,19727,17511,2216
2018,ERZURUM,767848,32501,35431,-2930
2018,ESKISEHIR,871187,35995,32946,3049
2018,GAZIANTEP,2028563,44704,62206,-17502
2018,GIRESUN,453912,40358,25953,14405
2018,GUMUSHANE,162748,30333,22764,7569
2018,HAKKARI,286470,12756,10156,2600
2018,HATAY,1609856,36499,42655,-6156
2018,ISPARTA,441412,28789,19584,9205
2018,MERSIN,1814468,55779,61917,-6138
2018,ISTANBUL,15067724,385482,595803,-210321
2018,IZMIR,4320519,130092,117113,12979
2018,KARS,288878,14441,16620,-2179
2018,KASTAMONU,383373,27175,18397,8778
2018,KAYSERI,1389680,38690,48047,-9357
2018,KIRKLARELI,360860,16936,14745,2191
2018,KIRSEHIR,241868,15835,12144,3691
2018,KOCAELI,1906391,80457,79970,487
2018,KONYA,2205609,58300,60571,-2271
2018,KUTAHYA,577941,22582,20392,2190
2018,MALATYA,797036,36901,35234,1667
2018,MANISA,1429643,41189,39056,2133
2018,KAHRAMANMARAS,1144851,33619,33661,-42
2018,MARDIN,829195,30216,31738,-1522
2018,MUGLA,967487,52642,34302,18340
2018,MUS,407992,15742,20789,-5047
2018,NEVSEHIR,298339,13120,12315,805
2018,NIGDE,364707,22654,15676,6978
2018,ORDU,771932,54813,30152,24661
2018,RIZE,348608,31266,16413,14853
2018,SAKARYA,1010700,37659,32704,4955
2018,SAMSUN,1335716,53228,48543,4685
2018,SIIRT,331670,15017,15726,-709
2018,SINOP,219733,20922,9793,11129
2018,SIVAS,646608,45861,26271,19590
2018,TEKIRDAG,1029927,53895,41010,12885
2018,TOKAT,612646,46391,41326,5065
2018,TRABZON,807903,46593,33344,13249
2018,TUNCELI,88198,11211,5884,5327
2018,SANLIURFA,2035809,44448,56748,-12300
2018,USAK,367514,13691,13011,680
2018,VAN,1123784,34691,44954,-10263
2018,YOZGAT,424981,25715,22524,3191
2018,ZONGULDAK,599698,24363,24105,258
2018,AKSARAY,412172,16680,14441,2239
2018,BAYBURT,82274,9450,7772,1678
2018,KARAMAN,251913,12777,10448,2329
2018,KIRIKKALE,286602,20575,15076,5499
2018,BATMAN,599103,23099,22525,574
2018,SIRNAK,524190,19779,15485,4294
2018,BARTIN,198999,13399,8813,4586
2018,ARDAHAN,98907,7342,6376,966
2018,IGDIR,197456,9225,10122,-897
2018,YALOVA,262234,16232,12905,3327
2018,KARABUK,248014,18384,17433,951
2018,KILIS,142541,8861,6929,1932
2018,OSMANIYE,534415,19965,20900,-935
2018,DUZCE,387844,17445,12790,4655
2017,ADANA,2216475,49509,62834,-13325
2017,ADIYAMAN,615076,18040,22741,-4701
2017,AFYONKARAHISAR,715693,21453,25483,-4030
2017,AGRI,536285,15088,32479,-17391
2017,AMASYA,329888,14326,14675,-349
2017,ANKARA,5445026,188100,156058,32042
2017,ANTALYA,2364396,87232,72178,15054
2017,ARTVIN,166143,7788,10146,-2358
2017,AYDIN,1080839,41352,35339,6013
2017,BALIKESIR,1204824,43998,40371,3627
2017,BILECIK,221693,11744,9359,2385
2017,BINGOL,273354,11979,11941,38
2017,BITLIS,341474,12989,19097,-6108
2017,BOLU,303184,14839,13643,1196
2017,BURDUR,264779,12745,11786,959
2017,BURSA,2936803,86119,64905,21214
2017,CANAKKALE,530417,26088,20540,5548
2017,CANKIRI,186074,13849,13504,345
2017,CORUM,528422,17214,20880,-3666
2017,DENIZLI,1018735,28855,25466,3389
2017,DIYARBAKIR,1699901,40493,48983,-8490
2017,EDIRNE,406855,19125,15999,3126
2017,ELAZIG,583671,20406,22054,-1648
2017,ERZINCAN,231511,15162,14210,952
2017,ERZURUM,760476,26624,37358,-10734
2017,ESKISEHIR,860620,38060,27799,10261
2017,GAZIANTEP,2005515,47431,50485,-3054
2017,GIRESUN,437393,25529,34675,-9146
2017,GUMUSHANE,170173,18795,27348,-8553
2017,HAKKARI,275761,9997,10380,-383
2017,HATAY,1575226,33745,40623,-6878
2017,ISPARTA,433830,18222,18818,-596
2017,MERSIN,1793931,54492,55393,-901
2017,ISTANBUL,15029231,416587,422559,-5972
2017,IZMIR,4279677,127394,102776,24618
2017,KARS,287654,11588,17119,-5531
2017,KASTAMONU,372373,18729,20052,-1323
2017,KAYSERI,1376722,38958,36863,2095
2017,KIRKLARELI,356050,16074,14023,2051
2017,KIRSEHIR,234529,10840,11329,-489
2017,KOCAELI,1883270,87796,60258,27538
2017,KONYA,2180149,53007,56594,-3587
2017,KUTAHYA,572256,17172,20393,-3221
2017,MALATYA,786676,27523,28222,-699
2017,MANISA,1413041,40257,36021,4236
2017,KAHRAMANMARAS,1127623,26874,30314,-3440
2017,MARDIN,809719,28303,30782,-2479
2017,MUGLA,938751,42450,33289,9161
2017,MUS,404544,13094,22243,-9149
2017,NEVSEHIR,292365,11006,12076,-1070
2017,NIGDE,352727,13948,15667,-1719
2017,ORDU,742341,28111,40305,-12194
2017,RIZE,331041,14561,16310,-1749
2017,SAKARYA,990214,35575,28122,7453
2017,SAMSUN,1312990,43709,42422,1287
2017,SIIRT,324394,12163,15406,-3243
2017,SINOP,207427,11015,10086,929
2017,SIVAS,621301,22147,28697,-6550
2017,TEKIRDAG,1005463,55391,34658,20733
2017,TOKAT,602086,34735,38746,-4011
2017,TRABZON,786326,29703,29192,511
2017,TUNCELI,82498,6074,6725,-651
2017,SANLIURFA,1985753,40058,52648,-12590
2017,USAK,364971,13909,10420,3489
2017,VAN,1106891,31971,48269,-16298
2017,YOZGAT,418650,19074,23498,-4424
2017,ZONGULDAK,596892,19421,22541,-3120
2017,AKSARAY,402404,14139,13799,340
2017,BAYBURT,80417,5648,15820,-10172
2017,KARAMAN,246672,8581,10340,-1759
2017,KIRIKKALE,278749,13434,14112,-678
2017,BATMAN,585252,19889,22323,-2434
2017,SIRNAK,503236,19672,15186,4486
2017,BARTIN,193577,8759,8144,615
2017,ARDAHAN,97096,5284,7154,-1870
2017,IGDIR,194775,7775,9728,-1953
2017,YALOVA,251203,15754,10719,5035
2017,KARABUK,244453,14740,14399,341
2017,KILIS,136319,6675,6526,149
2017,OSMANIYE,527724,18842,19008,-166
2017,DUZCE,377610,15023,11387,3636
2016,ADANA,2201670,51466,60759,-9293
2016,ADIYAMAN,610484,18789,21201,-2412
2016,AFYONKARAHISAR,714523,22467,24400,-1933
2016,AGRI,542255,14306,30811,-16505
2016,AMASYA,326351,15395,13609,1786
2016,ANKARA,5346518,177166,159915,17251
2016,ANTALYA,2328555,79203,73119,6084
2016,ARTVIN,168068,8240,9283,-1043
2016,AYDIN,1068260,40363,33119,7244
2016,BALIKESIR,1196176,43475,38566,4909
2016,BILECIK,218297,11031,9911,1120
2016,BINGOL,269560,10304,11205,-901
2016,BITLIS,341225,12571,18074,-5503
2016,BOLU,299896,18528,11762,6766
2016,BURDUR,261401,12337,11059,1278
2016,BURSA,2901396,84458,63812,20646
2016,CANAKKALE,519793,25116,20024,5092
2016,CANKIRI,183880,13371,13088,283
2016,CORUM,527863,16688,20420,-3732
2016,DENIZLI,1005687,28170,24794,3376
2016,DIYARBAKIR,1673119,39177,55604,-16427
2016,EDIRNE,401701,16623,17190,-567
2016,ELAZIG,578789,18990,20519,-1529
2016,ERZINCAN,226032,12666,12748,-82
2016,ERZURUM,762021,26957,36340,-9383
2016,ESKISEHIR,844842,36687,25785,10902
2016,GAZIANTEP,1974244,45726,50003,-4277
2016,GIRESUN,444467,35376,20284,15092
2016,GUMUSHANE,172034,26681,18343,8338
2016,HAKKARI,267813,5945,16067,-10122
2016,HATAY,1555165,34195,37627,-3432
2016,ISPARTA,427324,19899,17240,2659
2016,MERSIN,1773852,54962,52763,2199
2016,ISTANBUL,14804116,369582,440889,-71307
2016,IZMIR,4223545,122668,98902,23766
2016,KARS,289786,10209,16590,-6381
2016,KASTAMONU,376945,20577,18898,1679
2016,KAYSERI,1358980,35573,35540,33
2016,KIRKLARELI,351684,16882,13175,3707
2016,KIRSEHIR,229975,12188,11362,826
2016,KOCAELI,1830772,85602,60479,25123
2016,KONYA,2161303,56500,54712,1788
2016,KUTAHYA,573642,18382,20691,-2309
2016,MALATYA,781305,27777,27613,164
2016,MANISA,1396945,39999,35685,4314
2016,KAHRAMANMARAS,1112634,27307,28971,-1664
2016,MARDIN,796237,21439,38823,-17384
2016,MUGLA,923773,39076,31520,7556
2016,MUS,406501,11309,21683,-10374
2016,NEVSEHIR,290895,11703,11091,612
2016,NIGDE,351468,14823,13589,1234
2016,ORDU,750588,42995,27229,15766
2016,RIZE,331048,15006,15604,-598
2016,SAKARYA,976948,35228,28965,6263
2016,SAMSUN,1295927,41687,41187,500
2016,SIIRT,322664,10775,15068,-4293
2016,SINOP,205478,10190,9784,406
2016,SIVAS,621224,22966,26369,-3403
2016,TEKIRDAG,972875,56536,32290,24246
2016,TOKAT,602662,36572,33380,3192
2016,TRABZON,779379,28680,26775,1905
2016,TUNCELI,82193,4822,7031,-2209
2016,SANLIURFA,1940627,38662,49789,-11127
2016,USAK,358736,11737,10701,1036
2016,VAN,1100190,28902,49035,-20133
2016,YOZGAT,421041,17736,21825,-4089
2016,ZONGULDAK,597524,19991,21933,-1942
2016,AKSARAY,396673,15234,12294,2940
2016,BAYBURT,90154,16981,6653,10328
2016,KARAMAN,245610,9519,9813,-294
2016,KIRIKKALE,277984,14776,13300,1476
2016,BATMAN,576899,18757,21489,-2732
2016,SIRNAK,483788,11102,24122,-13020
2016,BARTIN,192389,8940,8108,832
2016,ARDAHAN,98335,5164,6880,-1716
2016,IGDIR,192785,6721,9368,-2647
2016,YALOVA,241665,12825,10493,2332
2016,KARABUK,242347,16719,13416,3303
2016,KILIS,130825,5740,8043,-2303
2016,OSMANIYE,522175,19558,17683,1875
2016,DUZCE,370371,15958,11119,4839
2015,ADANA,2183167,52647,64192,-11545
2015,ADIYAMAN,602774,18523,24064,-5541
2015,AFYONKARAHISAR,709015,22922,26226,-3304
2015,AGRI,547210,16597,32174,-15577
2015,AMASYA,322167,13957,15092,-1135
2015,ANKARA,5270575,204048,153001,51047
2015,ANTALYA,2288456,96441,68374,28067
2015,ARTVIN,168370,9050,10969,-1919
2015,AYDIN,1053506,42743,37689,5054
2015,BALIKESIR,1186688,43296,48892,-5596
2015,BILECIK,212361,10890,9806,1084
2015,BINGOL,267184,9906,13122,-3216
2015,BITLIS,340449,11936,18801,-6865
2015,BOLU,291095,14681,12401,2280
2015,BURDUR,258339,12537,12247,290
2015,BURSA,2842547,84253,64558,19695
2015,CANAKKALE,513341,25096,23005,2091
2015,CANKIRI,180945,12702,16148,-3446
2015,CORUM,525180,16286,22636,-6350
2015,DENIZLI,993442,30185,24961,5224
2015,DIYARBAKIR,1654196,36124,56025,-19901
2015,EDIRNE,402537,18779,17458,1321
2015,ELAZIG,574304,22170,21699,471
2015,ERZINCAN,222918,14062,16766,-2704
2015,ERZURUM,762321,29624,41803,-12179
2015,ESKISEHIR,826716,36041,28298,7743
2015,GAZIANTEP,1931836,46435,48858,-2423
2015,GIRESUN,426686,22308,26942,-4634
2015,GUMUSHANE,151449,20437,17737,2700
2015,HAKKARI,278775,8216,12983,-4767
2015,HATAY,1533507,32868,41519,-8651
2015,ISPARTA,421766,19042,18659,383
2015,MERSIN,1745221,56171,58404,-2233
2015,ISTANBUL,14657434,453407,402864,50543
2015,IZMIR,4168415,126238,105389,20849
2015,KARS,292660,11328,19809,-8481
2015,KASTAMONU,372633,21601,18092,3509
2015,KAYSERI,1341056,37832,36087,1745
2015,KIRKLARELI,346973,16098,13816,2282
2015,KIRSEHIR,225562,11928,11544,384
2015,KOCAELI,1780055,87158,56927,30231
2015,KONYA,2130544,56817,57056,-239
2015,KUTAHYA,571463,19447,22337,-2890
2015,MALATYA,772904,26925,31368,-4443
2015,MANISA,1380366,39558,36736,2822
2015,KAHRAMANMARAS,1096610,26856,32272,-5416
2015,MARDIN,796591,24255,34592,-10337
2015,MUGLA,908877,42112,37663,4449
2015,MUS,408728,12752,23855,-11103
2015,NEVSEHIR,286767,11144,11955,-811
2015,NIGDE,346114,13878,15959,-2081
2015,ORDU,728949,29835,32600,-2765
2015,RIZE,328979,15514,18936,-3422
2015,SAKARYA,953181,35943,28492,7451
2015,SAMSUN,1279884,41718,44627,-2909
2015,SIIRT,320351,10505,16166,-5661
2015,SINOP,204133,10059,11274,-1215
2015,SIVAS,618617,25319,33501,-8182
2015,TEKIRDAG,937910,54482,33937,20545
2015,TOKAT,593990,34586,40805,-6219
2015,TRABZON,768417,27314,32454,-5140
2015,TUNCELI,86076,6996,8133,-1137
2015,SANLIURFA,1892320,40135,50580,-10445
2015,USAK,353048,11044,11001,43
2015,VAN,1096397,30492,48061,-17569
2015,YOZGAT,419440,14933,26804,-11871
2015,ZONGULDAK,595907,18244,25340,-7096
2015,AKSARAY,386514,12205,14164,-1959
2015,BAYBURT,78550,7150,9281,-2131
2015,KARAMAN,242196,9195,9865,-670
2015,KIRIKKALE,270271,12585,15204,-2619
2015,BATMAN,566633,18872,23216,-4344
2015,SIRNAK,490184,11554,23615,-12061
2015,BARTIN,190708,8872,8113,759
2015,ARDAHAN,99265,5630,7802,-2172
2015,IGDIR,192435,7321,10589,-3268
2015,YALOVA,233009,13834,11497,2337
2015,KARABUK,236978,17017,12567,4450
2015,KILIS,130655,6776,6593,183
2015,OSMANIYE,512873,18567,19303,-736
2015,DUZCE,360388,13434,12088,1346
2014,ADANA,2165595,51562,63181,-11619
2014,ADIYAMAN,597835,16578,24330,-7752
2014,AFYONKARAHISAR,706371,21414,27100,-5686
2014,AGRI,549435,14480,30995,-16515
2014,AMASYA,321913,12970,14817,-1847
2014,ANKARA,5150072,203621,163612,40009
2014,ANTALYA,2222562,93057,64631,28426
2014,ARTVIN,169674,9551,10187,-636
2014,AYDIN,1041979,45842,32396,13446
2014,BALIKESIR,1189057,57551,39918,17633
2014,BILECIK,209925,10090,10114,-24
2014,BINGOL,266019,9400,12852,-3452
2014,BITLIS,338023,11447,17470,-6023
2014,BOLU,284789,13264,13065,199
2014,BURDUR,256898,10235,12271,-2036
2014,BURSA,2787539,80717,65027,15690
2014,CANAKKALE,511790,27429,20540,6889
2014,CANKIRI,183550,14519,23080,-8561
2014,CORUM,527220,15875,24652,-8777
2014,DENIZLI,978700,28279,24771,3508
2014,DIYARBAKIR,1635048,36920,48019,-11099
2014,EDIRNE,400280,16431,17108,-677
2014,ELAZIG,568753,19724,24162,-4438
2014,ERZINCAN,223633,15450,13641,1809
2014,ERZURUM,763320,27994,45209,-17215
2014,ESKISEHIR,812320,35927,27977,7950
2014,GAZIANTEP,1889466,46438,44415,2023
2014,GIRESUN,429984,26857,23620,3237
2014,GUMUSHANE,146353,18811,16071,2740
2014,HAKKARI,276287,7187,10897,-3710
2014,HATAY,1519836,32678,39181,-6503
2014,ISPARTA,418780,17966,19930,-1964
2014,MERSIN,1727255,55598,54843,755
2014,ISTANBUL,14377018,438998,424662,14336
2014,IZMIR,4113072,124439,101447,22992
2014,KARS,296466,10280,20020,-9740
2014,KASTAMONU,368907,17539,18163,-624
2014,KAYSERI,1322376,40957,33374,7583
2014,KIRKLARELI,343723,14553,13678,875
2014,KIRSEHIR,222707,10648,12199,-1551
2014,KOCAELI,1722795,79697,55060,24637
2014,KONYA,2108808,55798,55453,345
2014,KUTAHYA,571554,18734,21860,-3126
2014,MALATYA,769544,29285,31476,-2191
2014,MANISA,1367905,35570,38432,-2862
2014,KAHRAMANMARAS,1089038,27619,30903,-3284
2014,MARDIN,788996,22207,30796,-8589
2014,MUGLA,894509,48219,29671,18548
2014,MUS,411216,12077,22688,-10611
2014,NEVSEHIR,286250,10164,13165,-3001
2014,NIGDE,343898,13785,17946,-4161
2014,ORDU,724268,28555,39937,-11382
2014,RIZE,329779,17311,17932,-621
2014,SAKARYA,932706,32701,28311,4390
2014,SAMSUN,1269989,41057,44519,-3462
2014,SIIRT,318366,10551,14366,-3815
2014,SINOP,204526,10783,11950,-1167
2014,SIVAS,623116,29726,34855,-5129
2014,TEKIRDAG,906732,52994,31266,21728
2014,TOKAT,597920,35891,38737,-2846
2014,TRABZON,766782,31847,29741,2106
2014,TUNCELI,86527,7286,6810,476
2014,SANLIURFA,1845667,35670,49030,-13360
2014,USAK,349459,10190,10895,-705
2014,VAN,1085542,27587,44435,-16848
2014,YOZGAT,432560,16200,27722,-11522
2014,ZONGULDAK,598796,18115,24783,-6668
2014,AKSARAY,384252,11936,14577,-2641
2014,BAYBURT,80607,8912,5583,3329
2014,KARAMAN,240362,8673,9788,-1115
2014,KIRIKKALE,271092,13306,18744,-5438
2014,BATMAN,557593,18543,21515,-2972
2014,SIRNAK,488966,12749,16142,-3393
2014,BARTIN,189405,7794,8903,-1109
2014,ARDAHAN,100809,5323,8033,-2710
2014,IGDIR,192056,7407,9453,-2046
2014,YALOVA,226514,14680,11064,3616
2014,KARABUK,231333,13438,13195,243
2014,KILIS,128781,5759,7451,-1692
2014,OSMANIYE,506807,17880,18214,-334
2014,DUZCE,355549,11980,12249,-269
2013,ADANA,2149260,50598,62933,-12335
2013,ADIYAMAN,597184,15715,24077,-8362
2013,AFYONKARAHISAR,707123,22200,26799,-4599
2013,AGRI,551177,14725,28477,-13752
2013,AMASYA,321977,12379,14658,-2279
2013,ANKARA,5045083,186642,153791,32851
2013,ANTALYA,2158265,88605,64075,24530
2013,ARTVIN,169334,10053,8644,1409
2013,AYDIN,1020957,34688,32338,2350
2013,BALIKESIR,1162761,38710,39688,-978
2013,BILECIK,208888,10231,9202,1029
2013,BINGOL,265514,10968,10940,28
2013,BITLIS,337156,11314,16174,-4860
2013,BOLU,283496,13138,12401,737
2013,BURDUR,257267,11156,10001,1155
2013,BURSA,2740970,75518,61744,13774
2013,CANAKKALE,502328,24766,18238,6528
2013,CANKIRI,190909,22290,16991,5299
2013,CORUM,532080,17073,21460,-4387
2013,DENIZLI,963464,27088,24039,3049
2013,DIYARBAKIR,1607437,35466,47949,-12483
2013,EDIRNE,398582,16255,17000,-745
2013,ELAZIG,568239,21433,21303,130
2013,ERZINCAN,219996,12662,12884,-222
2013,ERZURUM,766729,23398,39997,-16599
2013,ESKISEHIR,799724,33893,28329,5564
2013,GAZIANTEP,1844438,41978,42291,-313
2013,GIRESUN,425007,23453,20170,3283
2013,GUMUSHANE,141412,16677,11162,5515
2013,HAKKARI,273041,8007,10293,-2286
2013,HATAY,1503066,29067,39315,-10248
2013,ISPARTA,417774,18730,19807,-1077
2013,MERSIN,1705774,51468,55482,-4014
2013,ISTANBUL,14160467,437922,371601,66321
2013,IZMIR,4061074,113673,99681,13992
2013,KARS,300874,11046,18072,-7026
2013,KASTAMONU,368093,19911,15658,4253
2013,KAYSERI,1295355,36580,33789,2791
2013,KIRKLARELI,340559,14120,13297,823
2013,KIRSEHIR,223498,11259,11346,-87
2013,KOCAELI,1676202,71159,54742,16417
2013,KONYA,2079225,51080,55006,-3926
2013,KUTAHYA,572059,17875,20915,-3040
2013,MALATYA,762538,25876,33194,-7318
2013,MANISA,1359463,36257,36989,-732
2013,KAHRAMANMARAS,1075706,24560,29322,-4762
2013,MARDIN,779738,22596,29525,-6929
2013,MUGLA,866665,35246,30687,4559
2013,MUS,412553,11070,20193,-9123
2013,NEVSEHIR,285460,10322,12147,-1825
2013,NIGDE,343658,14731,15493,-762
2013,ORDU,731452,30792,46332,-15540
2013,RIZE,328205,16842,15859,983
2013,SAKARYA,917373,30770,27170,3600
2013,SAMSUN,1261810,38644,42504,-3860
2013,SIIRT,314153,10866,13339,-2473
2013,SINOP,204568,12085,9869,2216
2013,SIVAS,623824,26354,30244,-3890
2013,TEKIRDAG,874475,45313,31681,13632
2013,TOKAT,598708,26987,47071,-20084
2013,TRABZON,758237,25115,29988,-4873
2013,TUNCELI,85428,8458,5612,2846
2013,SANLIURFA,1801980,33383,47429,-14046
2013,USAK,346508,10655,10493,162
2013,VAN,1070113,32118,38507,-6389
2013,YOZGAT,444211,16688,26572,-9884
2013,ZONGULDAK,601567,17006,25571,-8565
2013,AKSARAY,382806,11491,13726,-2235
2013,BAYBURT,75620,4787,4677,110
2013,KARAMAN,237939,8747,9445,-698
2013,KIRIKKALE,274658,15089,17818,-2729
2013,BATMAN,547581,18816,20209,-1393
2013,SIRNAK,475255,13031,13753,-722
2013,BARTIN,189139,7886,8133,-247
2013,ARDAHAN,102782,5254,7633,-2379
2013,IGDIR,190424,6882,9779,-2897
2013,YALOVA,220122,14670,9808,4862
2013,KARABUK,230251,13652,11676,1976
2013,KILIS,128586,6566,6161,405
2013,OSMANIYE,498981,17338,17605,-267
2013,DUZCE,351509,12367,11306,1061
2012,ADANA,2125635,45927,59294,-13367
2012,ADIYAMAN,595261,14323,22591,-8268
2012,AFYONKARAHISAR,703948,24167,21738,2429
2012,AGRI,552404,12856,27984,-15128
2012,AMASYA,322283,11228,13128,-1900
2012,ANKARA,4965542,160235,137834,22401
2012,ANTALYA,2092537,83596,62893,20703
2012,ARTVIN,167082,7286,7612,-326
2012,AYDIN,1006541,32412,29623,2789
2012,BALIKESIR,1160731,34922,35315,-393
2012,BILECIK,204116,10387,8118,2269
2012,BINGOL,262507,7569,11145,-3576
2012,BITLIS,337253,10998,16886,-5888
2012,BOLU,281080,13136,9677,3459
2012,BURDUR,254341,11473,8497,2976
2012,BURSA,2688171,67736,61520,6216
2012,CANAKKALE,493691,23252,14374,8878
2012,CANKIRI,184406,17050,10609,6441
2012,CORUM,529975,13289,20610,-7321
2012,DENIZLI,950557,24446,21992,2454
2012,DIYARBAKIR,1592167,30789,47575,-16786
2012,EDIRNE,399708,14813,13675,1138
2012,ELAZIG,562703,17108,18344,-1236
2012,ERZINCAN,217886,12192,10649,1543
2012,ERZURUM,778195,22551,33234,-10683
2012,ESKISEHIR,789750,32363,25299,7064
2012,GAZIANTEP,1799558,41672,39410,2262
2012,GIRESUN,419555,18027,17861,166
2012,GUMUSHANE,135216,11166,9001,2165
2012,HAKKARI,279982,5622,10137,-4515
2012,HATAY,1483674,27260,35139,-7879
2012,ISPARTA,416663,19731,14330,5401
2012,MERSIN,1682848,46721,53523,-6802
2012,ISTANBUL,13854740,384535,354074,30461
2012,IZMIR,4005459,105804,95954,9850
2012,KARS,304821,9706,16185,-6479
2012,KASTAMONU,359808,14340,13933,407
2012,KAYSERI,1274968,33917,30143,3774
2012,KIRKLARELI,341218,12548,11232,1316
2012,KIRSEHIR,221209,9733,9898,-165
2012,KOCAELI,1634691,62966,51561,11405
2012,KONYA,2052281,51981,48313,3668
2012,KUTAHYA,573421,20550,16702,3848
2012,MALATYA,762366,24270,28545,-4275
2012,MANISA,1346162,32211,34054,-1843
2012,KAHRAMANMARAS,1063174,19908,29467,-9559
2012,MARDIN,773026,21676,30299,-8623
2012,MUGLA,851145,33213,28301,4912
2012,MUS,413260,9914,20646,-10732
2012,NEVSEHIR,285190,10214,10859,-645
2012,NIGDE,340270,12359,13514,-1155
2012,ORDU,741371,48240,26595,21645
2012,RIZE,324152,12315,13856,-1541
2012,SAKARYA,902267,28457,23787,4670
2012,SAMSUN,1251722,32249,41561,-9312
2012,SIIRT,310879,8823,14628,-5805
2012,SINOP,201311,8277,10371,-2094
2012,SIVAS,623535,21492,27441,-5949
2012,TEKIRDAG,852321,42155,28042,14113
2012,TOKAT,613990,34725,31812,2913
2012,TRABZON,757898,21864,25478,-3614
2012,TUNCELI,86276,5171,5404,-233
2012,SANLIURFA,1762075,31890,44878,-12988
2012,USAK,342269,10351,9435,916
2012,VAN,1051975,50003,46639,3364
2012,YOZGAT,453211,14646,24525,-9879
2012,ZONGULDAK,606527,14279,22687,-8408
2012,AKSARAY,379915,10667,12374,-1707
2012,BAYBURT,75797,3664,4085,-421
2012,KARAMAN,235424,8191,8066,125
2012,KIRIKKALE,274727,13776,13912,-136
2012,BATMAN,534205,15906,20739,-4833
2012,SIRNAK,466982,11075,14617,-3542
2012,BARTIN,188436,7145,7330,-185
2012,ARDAHAN,106643,4923,5986,-1063
2012,IGDIR,190409,6429,8632,-2203
2012,YALOVA,211799,11353,9199,2154
2012,KARABUK,225145,13510,8444,5066
2012,KILIS,124320,4315,6075,-1760
2012,OSMANIYE,492135,15343,17340,-1997
2012,DUZCE,346493,10432,10579,-147
